Jason Ramsey	female
Marc Ortiz	male
Roger Rogers	female
Charles Blake	female
Joshua Roberts	female
Zachary Bradley	male
Monica Beasley	male
Adrian Hawkins	male
Debra Matthews	male
Deanna Reyes	female
Nicholas Calhoun	female
Christina Osborne	male
Stephen Olsen	female
Megan Hester	male
Stephanie Cooper	male
Wesley Nielsen	male
Jeffrey Gonzales	female
Wendy James	male
Carlos Jackson	male
Kathy Harrison	female
Dustin Grant	female
Chad Miller	male
Katherine Finley	female
Kevin Thomas	female
Mr. Zachary Garrett	female
Jessica Peck	female
Joseph Herrera	male
Cassandra Sosa	male
Chad Williams	female
Andrea Mitchell	female
Sherry Garrett	female
Timothy Murphy	male
Bradley Johnson DDS	male
Amanda Love	female
Martha Kline	female
Justin Mcgee	male
Alex Snyder	male
Brandon Boyd	male
Amber Powell	male
Stephanie Foster	female
Frank Johnson	female
Ashley Padilla	male
Annette Harris	female
Theresa Wilson	female
Lisa Booth	male
Keith Parsons	female
Mark Roberts	female
Miss Cynthia Green	female
Allen Riley	female
Vanessa Lopez	male
Richard Reed	male
Craig Lopez	female
Kevin Castro	male
Craig Reilly	male
Christine Jones	male
Elizabeth Washington	male
Todd Flores	male
Joshua Oliver	male
Kenneth Steele	male
Lindsay Edwards	female
Debra Robinson	male
Amanda Molina	female
Michael Thornton	female
Robert Kelly	female
Christopher Fuentes	male
Steven Kelley	male
Maria Moore	male
Kevin Fields	female
Amber Jones	male
Marcus Osborne	female
Jennifer Adams	female
Cesar Moore	male
Jordan Cruz	female
Frank Robinson	male
William Parker	male
Jill Thornton	female
Alexandra Nelson	female
Kenneth Martinez	male
Emma Lowe	female
William Garcia	male
Eric Wise III	female
Denise Bailey	male
Scott Alvarez	female
David Galloway	female
Alexander Carter	female
Rachel Fry	female
Sally Cole	male
Devin Walsh	male
Kimberly Weber	female
Dr. Julie Huynh MD	male
Timothy Peters	male
Michael Williams	male
Sarah Stark	male
Jennifer Reed	male
Jennifer Perez	female
Mark White	female
Carl White	female
Carrie Weaver	female
Abigail Walters	female
Mark Martinez	male